GGC	Gly
GAT	Asp
GGA	Gly
GGG	Gly
CGA	Arg
AAC	Asn
CTT	Leu
GCT	Ala
GAG	Glu
GAA	Glu
AGG	Arg
GAC	Asp
GGT	Gly
GCG	Ala
CTG	Leu
TGC	Cys
ATA	Ile
CTC	Leu
GCA	Ala
CTA	Leu
CGG	Arg
ACG	Thr
CGT	Arg
ACA	Thr
CAT	His
ACC	Thr
AAG	Lys
GCC	Ala
TAT	Tyr
TGG	Trp
TCT	Ser
TGA	Stop
AAA	Lys
CCT	Pro
CAA	Gln
ACT	Thr
CAC	His
CGC	Arg
CAG	Gln
CCC	Pro
TCA	Ser
CCA	Pro
TCC	Ser
CCG	Pro
TAC	Tyr
TCG	Ser
ATG	Met
TTT	Phe
ATC	Ile
TTA	Leu
TGT	Cys
TTC	Phe
TTG	Leu
TAG	Stop
ATT	Ile
AAT	Asn
GTC	Val
GTA	Val
GTG	Val
AGT	Ser
AGA	Arg
TAA	Stop
AGC	Ser
GTT	Val
